NO ./assets/textures/BRICK_1A.xpm
SO ./assets/textures/BRICK_2A.xpm
WE ./assets/textures/BRICK_3D.xpm
EA ./assets/textures/BRICK_4A.xpm

F 225,255,255
C 0,0,0




11111111111111111111111111111111111
10000000000000000000000000000000001
10000000000000000000000000000000001
10000000000000000000000000000000001
10000000000000000000000000000000001
1000000000000000000000000000000W001
11111111111111111111111111111111111
