111111111111
1001000C0001
1000N0001101
1P0000E00001
111111111111
