111111111111
1001000C0001
100000E01101
1P0000000001
111111111111
