111111111111
1001000J0001
100000001101
1P0000E00001
111111111111
