1111111111111
10010000000C1
1000011111001
1PPP11EPPPPP1
1111111111111